11111111111111111111111111111111111111111111111111111111111111111111111111111111111111111
10000000000001011101000100000110000000000000000000000000000010100000100010100000000000001
11101111711101000001010101010000111111010111111110101111111010101110101010101111111111101
10101000000101116101010101011110001100010100000000101000001010101010001010101111111111101
10100010110100000001010101000010101101110101111111101000001010001010111010101111111111101
10111110000111101111010101011010101101110101111111101000001011111010100010101111111111101
10000000100100100000000100001010101101110100000000101111111000000000111110101117111111101
11111101100100110111110110101010101101110111111110101000001010111100001110100000000000001
10000000100100000000000010100010101101160000000010101011101010100111100010111111111010101
10111111100111111111111010101110101101110111111010101010101010100000111010000000001010101
10100100000000000000001010001000101101110000001010101010101010111100001011111111101010101
10110101111111111111101010101011101101110111111010101010101010000101101010000000001111101
10000000000000000000101000001010001100010000000010101010101011111101101010100001611010001
11110101111111111110101011111010111111010111111110101010101110000000001010100010001010101
10000100000000000000101000000100000000010000000000001001101000111111001011101111101010101
10111101111111111111101110111111110111111111111111111000101100100000001000101000101010101
10000100000000000000000010000000000000000000000000001110100100101117111010111010111000101
11110111111111111111111011111111111111111111111111101010000000100000000010001010000011111
10100000101000001010000010000000000000000000000000101011111111101111111110101011111110001
10101110101111100011111011110111110110710110110110101010100000000000100000101000000000101
10101010100000000000101000000000010110110110110110101010101111111100101011101111111611101
10111010101111111110101111111111010110110110110110101010001000000100101010100000100000101
10000000001000000000000000000001010110110110110110101011111011110100101010111010111010101
10111011111111111110111111111101010110110110110110101010000000000000001010000010000010101
10101000100001000010101010000001010110110110110110101011111111011111111011110011111110101
10101110111101011010100000110101010110110110110110101000000101010100010001000001000000001
10100000000101011010111010110101010110110110110110101111111101010001000101111101011111111
10101111110100000000001110110100010000000000000000101000000100101111111111000101000000001
10100000010101010101100010110111116111110111111111101011111110000000000001110111111110101
10161111110101111111101111110000000000010000000000001010000010111110111001010100000000101
10001000000001000010000000000101111111010111111111111010111010100000001001010111111100101
10101111111111101011111111111101111111000000010001010000101011101110101001010000000111111
10100000001000101000000000000107111111011011010101011111101000001010101111011111110100001
11111111101110101111110111110101111111010001010101010000001011101010101000000000000111101
10000000101000001000000000010101111111010101000100010000001010101010101001111111000000001
10101010101010101001110111010111111111110101111110111111111010111010101001000001111111111
10111010111010101001000001010000000000000100000010100000000010000010100001011101000000001
10000010000010101001111111010111111111111111111010111111111110111110111111010101101111101
10111000101000001000000000010101000001000100000010100010000100101010100000010000000000001
10101111101111111001111111110101111101110111111010101010101110101010111111010111111111101
10101000101000000000000000000100010000000100000010101000100010101010000000010100000000101
10101010101001100111111111110101010111010101111010111111101010101011111111010101611110101
10101010001000000100001000010101011111110101111010000000101010101010000001010100000010101
10101011111110111111101011010101000000000101111011110110101010101010110101010111111110101
10100000000000100000001011010111111111111101111010000010101010101010110101010000000000101
10111111111110111101111011010000010100010001001000111010101011101010710101010111101111101
10000010000000000000001011011111010001000100000010111010101000001010110101000000010000101
11111010111101111111101011000001011111111111111111111110101111111011111101111111111111101
10010010000001000100000011111101000000000000000000000000000000000000000000000000000000001
11010011111111010101111011111101011111111111111111111111111111111111111111101010111111111
10010000000000000101000010000001010000000010000100010001000100000000000000101010100000001
10111711111111110101010111111101011110111010110001010100010000011111161110101010111111101
10100000000000010101010100000000000010101010010101011111111111011111111110101010100000001
10101111111111010101010101111111116110101011111101000000000001011111111110101010111011111
10101111111111010101010100010000000000101000000001011101111101011111111110101010101010001
10107111111111010101010101011111111111101111171111010001000101011111111110100010101010101
10101111111111010100010001010000000000001000000000010100010101000000000000111010101010161
10101111111111010111111111011111111111101111111111010111110101111111111111100010101010101
10101111111111010000000000000000000000000000000001010100000000000000000000101010101000101
10101111111111011111111111111111111111111111111101010111111111111111111110701010101111101
10101111111111010100000000000000000000000000000101010100000000000000000010101010101010001
10106111111111010101111111161111111111111111110101110101111111111111111011111010101000101
10101111111111010101111111111111111111111111110100000000000000000000000000000010101110101
10100000000000000101111111111111111111111111110101011111111111111101111116111110101010101
10111111111111110100011111111111700000000000000101010000000000000101000000000000100010101
10000000000000000111011111111111101111111111111101010111111111110101111111111111101010101
11111111111111110101011111111111101000000000000101010100010001010101111111111111101010101
10000000000000000001011111111111101111111111010101010001000100010100000000000000001010101
11111111111111111101011111111111100000000000000101011111111111110101111111111111111111101
10000000000000000101071111111111101111111111111100000000000000000101000000000000000000001
10110110110110110101000000000000001000000000000101011111111111111101111111111111111101111
10110110110110110101011111111111111011111111110100000000000000000000000000000000000100001
10110110110110110101011100000000000010000000010111111111111111111111111111111111110101101
10710110110110110111000101111111111111011111010000000001000000000000000000000100010101101
10110110110110110001110101000000000001010101011111111101111111111111111111110111010101701
10110110110110110101010101011111111101010000000000000101010000100010001000000101010101101
10110110110110110101010001010100000001010111111111010101000100001000101001010001010101101
10110110110110110101011101000101111101010000010000010101011111111111101011011111010101101
10110110110110110100000001010101000101010111111111010101010000000000001010000000010101101
10000000000000000111111101000001010101010000010000010101011111161111111010111111110101101
10110110110110110101010101010101011101011111111101110100000000000000000010100000010111111
10110110110110110101010001000101000001000000000101000111111111111111111010101111010000001
10110110110110110101010101111111111111111111111101010000000000000000000010101111011111101
10110110110110110101000100000000000000000000000001010111111111111101110010100000000000101
10110110110110110101111111611111111111111111111111110000000000000101010010111111111110101
10110110110110110100000100010001000100010001000100010111111111111101011110001000100010101
10110110110110110111010101010101010101010101010101010100000000000001000000100010001010101
10110110110110110101010101010101070101010101010101010101111111111111111111111111111110701
10110110110110110100010001000100010001000100010001000100000000000000000000000000000000001
11111111111111111111111111111111111111111111111111111111111111111111111111111111111111111
